60 60 750
500 250 10
9 5 15 1
50 55 15 3
BBBBBBBBBBBBBBBBBBBBBBBBBBBBBBBBBBBBBBBBBBBBBBBBBBBBBBBBBBBB
BEEEEEEEEEEEEEEEEEEEEEEEEEEEEEEEEEEEEEEEEEEEEEEEEEEEEEEEEEEB
BEEEEEEEEEEEEEEEEEEEEEEEEEEEEEEEEEEEEEEEEEEEEEEEEEEEEEEEEEEB
BEEEEEEEEBBBEEEEEEEEEEEEEEEEEEBBEEEEEEEEEEEBEEEBBBEEEEBEEEEB
BEEEEEEEEBBBEEEEEEEEEEEEEEEBBBBBEEEEEEEEEEBBEEEBEEEEEEBBEEEB
BEEEEEEEEEEEEEEEEEEEEEEEEEEBBBBBEEEEEEEEEEBEEEEEEEEEEEEBEEEB
BEEEEEEEEEEEEEEEEEEEEEEEEEEEEEEEEEEEEEEEEEEEEEEEEEEEEEEEEEEB
BEEEEEEEEEEEEEEEEEEEEEEEEEEEEEEEEEEEEEEEEEEEEEEEEEEEEEEEEEEB
BEEEEEEEEEEEEEEEEEEEEEEEEEEEEEEEEEEEEEEEEEEEEEEEEEEEEEEEEEEB
BEEBBBEEEBBBEEEEEBEEEBBBEEEBBEEEEEEBBBEEEBBBEEEEBEEEEEBEEEEB
BEEBBBEEEBBBEEEEBBEEEBBBEEEBBEEEEEEEEBEEEBBBEEEEBBEEEEBBEEEB
BEEEEEEEEEEEEEEEBEEEEBBBEEEBBEEEEEEEEEEEEBBBEEEEEBEEEEEBEEEB
BEEEEEEEEEEEEEEEEEEEEEEEEEEEEEEEEEEEEEEEEEEEEEEEEEEEEEEEEEEB
BEEEEEEEEEEEEEEEEEEEEEEEEEEEEEEEEEEEEEEEEEEEEEEEEEEEEEEEEEEB
BEEEEEEEEEEEEEEEEEEEEEEEEEEEEEEEEEEEEEEEEEEEEEEEEEEEEEEEEEEB
BEEEEEEEEEBBEEEBBBEEEBBBEEEEEBBEEEEEBBEEEBBEEEEBBBEEEEBBEEEB
BEEBBBEEEEBBEEEBBBEEEBEEEEEEBBBEEEEEBBEEEBBEEEEEEBEEEEBBEEEB
BEEBBBEEEEBBEEEBBBEEEEEEEEEEBEBEEEEEBBEEEBBEEEEEEEEEEEBBEEEB
BEEEEEEEEEEEEEEEEEEEEEEEEEEEEEEEEEEEEEEEEEEEEEEEEEEEEEEEEEEB
BEEEEEEEEEEEEEEEEEEEEEEEEEEEEEEEEEEEEEEEEEEEEEEEEEEEEEEEEEEB
BEEEEEEEEEEEEEEEEEEEEEEEEEEEEEEEEEEEEEEEEEEEEEEEEEEEEEEEEEEB
BEEBBBEEEBBBEEEEEEEEEBBBEEEEEBBBEEEEBEEEEEBEEEEEEEEEEBBBEEEB
BEEBBBEEEBBBEEEBBBEEEBEEEEEEBBBBEEEEBBEEEBBEEEEEEBEEEBBBEEEB
BEEEEEEEEBBBEEEBBBEEEEEEEEEEBEBBEEEEEBEEEBEEEEEBBBEEEEEEEEEB
BEEEEEEEEEEEEEEEEEEEEEEEEEEEEEEEEEEEEEEEEEEEEEEEEEEEEEEEEEEB
BEEEEEEEEEEEEEEEEEEEEEEEEEEEEEEEEEEEEEEEEEEEEEEEEEEEEEEEEEEB
BEEEEEEEEEEEEEEEEEEEEEEEEEEEEEEEEEEEEEEEEEEEEEEEEEEEEEEEEEEB
BEEEBEEEEBBBEEEEEEEEEEEEEEEEEBBBEEEEEEEEEEEEEEEEBBEEEEBBEEEB
BEEBBEEEEBEEEEEEEEEEEBEEEEEEBBEEEEEEEEEEEEEEEEEEBBEEEEBBEEEB
BEEBEEEEEEEEEEEEEEEEEBBBEEEEBEEEEEEEEEEEEEEEEEEEBBEEEEBBEEEB
BEEEEEEEEEEEEEEEEEEEEEEEEEEEEEEEEEEEEEEEEEEEEEEEEEEEEEEEEEEB
BEEEEEEEEEEEEEEEEEEEEEEEEEEEEEEEEEEEEEEEEEEEEEEEEEEEEEEEEEEB
BEEEEEEEEEEEEEEEEEEEEEEEEEEEEEEEEEEEEEEEEEEEEEEEEEEEEEEEEEEB
BEEEBEEEEEBEEEEBBEEEEEBEEEEBBBEEEEEEBEEEEEBEEEEBBBEEEEEEEEEB
BEEBBEEEEEBBEEEBBEEEEBBEEEEBBBEEEEEBBEEEEEBBEEEEEBEEEEEEEEEB
BEEBEEEEEEEBEEEBBEEEEBEEEEEBBBEEEEEBEEEEEEEBEEEEEEEEEEEEEEEB
BEEEEEEEEEEEEEEEEEEEEEEEEEEEEEEEEEEEEEEEEEEEEEEEEEEEEEEEEEEB
BEEEEEEEEEEEEEEEEEEEEEEEEEEEEEEEEEEEEEEEEEEEEEEEEEEEEEEEEEEB
BEEEEEEEEEEEEEEEEEEEEEEEEEEEEEEEEEEEEEEEEEEEEEEEEEEEEEEEEEEB
BEEEEEEEEEEEEEEBBBEEEBBEEEEBBBBBEEEEEBEEEEBEEEEEEEEEEBEEEEEB
BEEEEBEEEBBBEEEBBBEEEBBEEEEBEEBBEEEEBBEEEEBBEEEBEEEEEBBEEEEB
BEEBBBEEEBBBEEEBBBEEEBBEEEEEEEEEEEEEBEEEEEEBEEEBBBEEEEBEEEEB
BEEEEEEEEEEEEEEEEEEEEEEEEEEEEEEEEEEEEEEEEEEEEEEEEEEEEEEEEEEB
BEEEEEEEEEEEEEEEEEEEEEEEEEEEEEEEEEEEEEEEEEEEEEEEEEEEEEEEEEEB
BEEEEEEEEEEEEEEEEEEEEEEEEEEEEEEEEEEEEEEEEEEEEEEEEEEEEEEEEEEB
BEEBBBEEEEBBEEEBEEEEEEEEEEEEBEBEEEEEEEEEEEEEEEEEEEEEEEBEEEEB
BEEEEBEEEEBBEEEBBEEEEEEBEEEEBBBBEEEEEEEEEEEEEEEBEEEEEBBEEEEB
BEEEEEEEEEBBEEEEBEEEEBBBEEEEEBEBEEEEEEEEEEEEEEEBBBEEEBEEEEEB
BEEEEEEEEEEEEEEEEEEEEEEEEEEEEEEEEEEEEEEEEEEEEEEEEEEEEEEEEEEB
BEEEEEEEEEEEEEEEEEEEEEEEEEEEEEEEEEEEEEEEEEEEEEEEEEEEEEEEEEEB
BEEEEEEEEEEEEEEEEEEEEEEEEEEEEEEEEEEEEEEEEEEEEEEEEEEEEEEEEEEB
BEEEBBEEEBEEEEEEBEEEEBBBEEEBEEBEEEEEEEEEEEEEEEEEEBEEEEEEEEEB
BEEEBBEEEBBEEEEBBEEEEBEEEEEBBEBBEEEEEEEEEBBBEEEEBBEEEEEEEEEB
BEEEBBEEEEBEEEEBEEEEEEEEEEEEBEEBEEEEEEEEEBBBEEEEBEEEEEEEEEEB
BEEEEEEEEEEEEEEEEEEEEEEEEEEEEEEEEEEEEEEEEEEEEEEEEEEEEEEEEEEB
BEEEEEEEEEEEEEEEEEEEEEEEEEEEEEEEEEEEEEEEEEEEEEEEEEEEEEEEEEEB
BEEEEEEEEEEEEEEEEEEEEEEEEEEEEEEEEEEEEEEEEEEEEEEEEEEEEEEEEEEB
BEEEEEEEEEEEEEEEEEEEEEEEEEEEEEEEEEEEEEEEEEEEEEEEEEEEEEEEEEEB
BEEEEEEEEEEEEEEEEEEEEEEEEEEEEEEEEEEEEEEEEEEEEEEEEEEEEEEEEEEB
BBBBBBBBBBBBBBBBBBBBBBBBBBBBBBBBBBBBBBBBBBBBBBBBBBBBBBBBBBBB