100 60 500
500 250 10
9 5 15 1
90 55 15 3
BBBBBBBBBBBBBBBBBBBBBBBBBBBBBBBBBBBBBBBBBBBBBBBBBBBBBBBBBBBBBBBBBBBBBBBBBBBBBBBBBBBBBBBBBBBBBBBBBBBB
BEEEEEEEEEEEEEEEEEEEEEEEEEEEEEEEEEEEEEEEEEEEEEEEEEEEEEEEEEEEEEEEEEEEEEEEEEEEEEEEEEEEEEEEEEEEEEEEEEEB
BEEEEEEEEEEEEEEEEEEEEEEEEEEEEEEEEEEEEEEEEEEEEEEEEEEEEEEEEEEEEEEEEEEEEEEEEEEEEEEEEEEEEEEEEEEEEEEEEEEB
BEEEEEEEEBBBEEEEEEEEEEEEEEEEEEEEEBBBEEEBBEEEEBBEEEEEEEEEEBBBEEEBBBEEEEBBEEEEEEEEEEEBEEEBBBEEEEBEEEEB
BEEEEEEEEBBBEEEEEEEEEEEEEEEBBBEEEBBBEEEBBEEEEBBEEEEEEEEEEBBBEEEBEEEEEEBBEEEEEEEEEEBBEEEBEEEEEEBBEEEB
BEEEEEEEEEEEEEEEEEEEEEEEEEEBBBEEEBBBEEEBBEEEEBBEEEEEEEEEEBBBEEEEEEEEEEBBEEEEEEEEEEBEEEEEEEEEEEEBEEEB
BEEEEEEEEEEEEEEEEEEEEEEEEEEEEEEEEEEEEEEEEEEEEEEEEEEEEEEEEEEEEEEEEEEEEEEEEEEEEEEEEEEEEEEEEEEEEEEEEEEB
BEEEEEEEEEEEEEEEEEEEEEEEEEEEEEEEEEEEEEEEEEEEEEEEEEEEEEEEEEEEEEEEEEEEEEEEEEEEEEEEEEEEEEEEEEEEEEEEEEEB
BEEEEEEEEEEEEEEEEEEEEEEEEEEEEEEEEEEEEEEEEEEEEEEEEEEEEEEEEEEEEEEEEEEEEEEEEEEEEEEEEEEEEEEEEEEEEEEEEEEB
BEEBBBEEEBBBEEEEEBEEEBBBEEEBBEEEEEEEEEEBBBEEEEBEEEEBBBEEEEBEEEEEEBEEEEEEEEEBBBEEEBBBEEEEBEEEEEBEEEEB
BEEBBBEEEBBBEEEEBBEEEBBBEEEBBEEEEEEBEEEBEEEEEBBEEEEBEEEEEEBBEEEEBBEEEEEEEEEEEBEEEBBBEEEEBBEEEEBBEEEB
BEEEEEEEEEEEEEEEBEEEEBBBEEEBBEEEEBBBEEEEEEEEEBEEEEEEEEEEEEEBEEEEBEEEEEEEEEEEEEEEEBBBEEEEEBEEEEEBEEEB
BEEEEEEEEEEEEEEEEEEEEEEEEEEEEEEEEEEEEEEEEEEEEEEEEEEEEEEEEEEEEEEEEEEEEEEEEEEEEEEEEEEEEEEEEEEEEEEEEEEB
BEEEEEEEEEEEEEEEEEEEEEEEEEEEEEEEEEEEEEEEEEEEEEEEEEEEEEEEEEEEEEEEEEEEEEEEEEEEEEEEEEEEEEEEEEEEEEEEEEEB
BEEEEEEEEEEEEEEEEEEEEEEEEEEEEEEEEEEEEEEEEEEEEEEEEEEEEEEEEEEEEEEEEEEEEEEEEEEEEEEEEEEEEEEEEEEEEEEEEEEB
BEEEEEEEEEBBEEEBBBEEEBBBEEEEEBEEEEEEEEEBBBEEEBBBEEEBBBEEEEEEEEEBBBEEEBBEEEEEBBEEEBBEEEEBBBEEEEBBEEEB
BEEBBBEEEEBBEEEBBBEEEBEEEEEEBBEEEEEEEEEBBBEEEEEBEEEBEEEEEBEEEEEBBBEEEBBEEEEEBBEEEBBEEEEEEBEEEEBBEEEB
BEEBBBEEEEBBEEEBBBEEEEEEEEEEBEEEEEEEEEEBBBEEEEEEEEEEEEEEEBBBEEEBBBEEEBBEEEEEBBEEEBBEEEEEEEEEEEBBEEEB
BEEEEEEEEEEEEEEEEEEEEEEEEEEEEEEEEEEEEEEEEEEEEEEEEEEEEEEEEEEEEEEEEEEEEEEEEEEEEEEEEEEEEEEEEEEEEEEEEEEB
BEEEEEEEEEEEEEEEEEEEEEEEEEEEEEEEEEEEEEEEEEEEEEEEEEEEEEEEEEEEEEEEEEEEEEEEEEEEEEEEEEEEEEEEEEEEEEEEEEEB
BEEEEEEEEEEEEEEEEEEEEEEEEEEEEEEEEEEEEEEEEEEEEEEEEEEEEEEEEEEEEEEEEEEEEEEEEEEEEEEEEEEEEEEEEEEEEEEEEEEB
BEEBBBEEEBBBEEEEEEEEEBBBEEEEEBEEEBBBEEEBEEEEEEEEEEEBEEEEEEEEEEEEBBEEEBBBEEEEBEEEEEBEEEEEEEEEEBBBEEEB
BEEBBBEEEBBBEEEBBBEEEBEEEEEEBBEEEBBBEEEBBEEEEEEEEEEBBEEEEBBBEEEEBBEEEBBBEEEEBBEEEBBEEEEEEBEEEBBBEEEB
BEEEEEEEEBBBEEEBBBEEEEEEEEEEBEEEEBBBEEEEBEEEEEEEEEEEBEEEEBBBEEEEBBEEEBBBEEEEEBEEEBEEEEEBBBEEEEEEEEEB
BEEEEEEEEEEEEEEEEEEEEEEEEEEEEEEEEEEEEEEEEEEEEEEEEEEEEEEEEEEEEEEEEEEEEEEEEEEEEEEEEEEEEEEEEEEEEEEEEEEB
BEEEEEEEEEEEEEEEEEEEEEEEEEEEEEEEEEEEEEEEEEEEEEEEEEEEEEEEEEEEEEEEEEEEEEEEEEEEEEEEEEEEEEEEEEEEEEEEEEEB
BEEEEEEEEEEEEEEEEEEEEEEEEEEEEEEEEEEEEEEEEEEEEEEEEEEEEEEEEEEEEEEEEEEEEEEEEEEEEEEEEEEEEEEEEEEEEEEEEEEB
BEEEBEEEEBBBEEEEEEEEEEEEEEEEEBEEEEEEEEEEBEEEEEEEEEEEEEEEEBBEEEEEEEEEEBBBEEEEEEEEEEEEEEEEBBEEEEBBEEEB
BEEBBEEEEBEEEEEEEEEEEBEEEEEEBBEEEEEBEEEEBBEEEEEBEEEBEEEEEBBEEEEEEEEEEBEEEEEEEEEEEEEEEEEEBBEEEEBBEEEB
BEEBEEEEEEEEEEEEEEEEEBBBEEEEBEEEEBBBEEEEEBEEEBBBEEEBBBEEEBBEEEEEEEEEEEEEEEEEEEEEEEEEEEEEBBEEEEBBEEEB
BEEEEEEEEEEEEEEEEEEEEEEEEEEEEEEEEEEEEEEEEEEEEEEEEEEEEEEEEEEEEEEEEEEEEEEEEEEEEEEEEEEEEEEEEEEEEEEEEEEB
BEEEEEEEEEEEEEEEEEEEEEEEEEEEEEEEEEEEEEEEEEEEEEEEEEEEEEEEEEEEEEEEEEEEEEEEEEEEEEEEEEEEEEEEEEEEEEEEEEEB
BEEEEEEEEEEEEEEEEEEEEEEEEEEEEEEEEEEEEEEEEEEEEEEEEEEEEEEEEEEEEEEEEEEEEEEEEEEEEEEEEEEEEEEEEEEEEEEEEEEB
BEEEBEEEEEBEEEEBBEEEEEBEEEEBBBEEEEEEEEEEEEEEEEEEEEEEEEEEEBBBEEEBEEEEEEEEEEEEBEEEEEBEEEEBBBEEEEEEEEEB
BEEBBEEEEEBBEEEBBEEEEBBEEEEBBBEEEEEEEEEEEBEEEEEEEEEEEEEEEBBBEEEBBEEEEEEEEEEBBEEEEEBBEEEEEBEEEEEEEEEB
BEEBEEEEEEEBEEEBBEEEEBEEEEEBBBEEEEEEEEEBBBEEEEEEEEEEEEEEEEEEEEEEBEEEEEEEEEEBEEEEEEEBEEEEEEEEEEEEEEEB
BEEEEEEEEEEEEEEEEEEEEEEEEEEEEEEEEEEEEEEEEEEEEEEEEEEEEEEEEEEEEEEEEEEEEEEEEEEEEEEEEEEEEEEEEEEEEEEEEEEB
BEEEEEEEEEEEEEEEEEEEEEEEEEEEEEEEEEEEEEEEEEEEEEEEEEEEEEEEEEEEEEEEEEEEEEEEEEEEEEEEEEEEEEEEEEEEEEEEEEEB
BEEEEEEEEEEEEEEEEEEEEEEEEEEEEEEEEEEEEEEEEEEEEEEEEEEEEEEEEEEEEEEEEEEEEEEEEEEEEEEEEEEEEEEEEEEEEEEEEEEB
BEEEEEEEEEEEEEEBBBEEEBBEEEEBBBEEEBBEEEEEBEEEEBEEEEEEEEEEEEEBEEEEEEEEEBBBEEEEEBEEEEBEEEEEEEEEEBEEEEEB
BEEEEBEEEBBBEEEBBBEEEBBEEEEBEEEEEBBEEEEEBBEEEBBEEEEBBBEEEEBBEEEEEBEEEBBBEEEEBBEEEEBBEEEBEEEEEBBEEEEB
BEEBBBEEEBBBEEEBBBEEEBBEEEEEEEEEEBBEEEEEEBEEEEBEEEEBBBEEEEBEEEEBBBEEEEEEEEEEBEEEEEEBEEEBBBEEEEBEEEEB
BEEEEEEEEEEEEEEEEEEEEEEEEEEEEEEEEEEEEEEEEEEEEEEEEEEEEEEEEEEEEEEEEEEEEEEEEEEEEEEEEEEEEEEEEEEEEEEEEEEB
BEEEEEEEEEEEEEEEEEEEEEEEEEEEEEEEEEEEEEEEEEEEEEEEEEEEEEEEEEEEEEEEEEEEEEEEEEEEEEEEEEEEEEEEEEEEEEEEEEEB
BEEEEEEEEEEEEEEEEEEEEEEEEEEEEEEEEEEEEEEEEEEEEEEEEEEEEEEEEEEEEEEEEEEEEEEEEEEEEEEEEEEEEEEEEEEEEEEEEEEB
BEEBBBEEEEBBEEEBEEEEEEEEEEEEBEEEEEEEEEEEEEEEEBBBEEEEEEEEEBBBEEEBBBEEEEBEEEEEEEEEEEEEEEEEEEEEEEBEEEEB
BEEEEBEEEEBBEEEBBEEEEEEBEEEEBBEEEEEBEEEBBBEEEBBBEEEEEBEEEBBBEEEEEBEEEEBBEEEEEEEEEEEEEEEBEEEEEBBEEEEB
BEEEEEEEEEBBEEEEBEEEEBBBEEEEEBEEEBBBEEEBBBEEEEEEEEEBBBEEEBBBEEEEEEEEEEEBEEEEEEEEEEEEEEEBBBEEEBEEEEEB
BEEEEEEEEEEEEEEEEEEEEEEEEEEEEEEEEEEEEEEEEEEEEEEEEEEEEEEEEEEEEEEEEEEEEEEEEEEEEEEEEEEEEEEEEEEEEEEEEEEB
BEEEEEEEEEEEEEEEEEEEEEEEEEEEEEEEEEEEEEEEEEEEEEEEEEEEEEEEEEEEEEEEEEEEEEEEEEEEEEEEEEEEEEEEEEEEEEEEEEEB
BEEEEEEEEEEEEEEEEEEEEEEEEEEEEEEEEEEEEEEEEEEEEEEEEEEEEEEEEEEEEEEEEEEEEEEEEEEEEEEEEEEEEEEEEEEEEEEEEEEB
BEEEBBEEEBEEEEEEBEEEEBBBEEEBEEEEEBBBEEEEBBEEEBBEEEEBBEEEEEBEEEEEEEEEEEBEEEEEEEEEEEEEEEEEEBEEEEEEEEEB
BEEEBBEEEBBEEEEBBEEEEBEEEEEBBEEEEBBBEEEEBBEEEBBEEEEBBEEEEEBBEEEBBBEEEEBBEEEEEEEEEBBBEEEEBBEEEEEEEEEB
BEEEBBEEEEBEEEEBEEEEEEEEEEEEBEEEEEEEEEEEBBEEEBBEEEEBBEEEEEEBEEEBBBEEEEEBEEEEEEEEEBBBEEEEBEEEEEEEEEEB
BEEEEEEEEEEEEEEEEEEEEEEEEEEEEEEEEEEEEEEEEEEEEEEEEEEEEEEEEEEEEEEEEEEEEEEEEEEEEEEEEEEEEEEEEEEEEEEEEEEB
BEEEEEEEEEEEEEEEEEEEEEEEEEEEEEEEEEEEEEEEEEEEEEEEEEEEEEEEEEEEEEEEEEEEEEEEEEEEEEEEEEEEEEEEEEEEEEEEEEEB
BEEEEEEEEEEEEEEEEEEEEEEEEEEEEEEEEEEEEEEEEEEEEEEEEEEEEEEEEEEEEEEEEEEEEEEEEEEEEEEEEEEEEEEEEEEEEEEEEEEB
BEEEEEEEEEEEEEEEEEEEEEEEEEEEEEEEEEEEEEEEEEEEEEEEEEEEEEEEEEEEEEEEEEEEEEEEEEEEEEEEEEEEEEEEEEEEEEEEEEEB
BEEEEEEEEEEEEEEEEEEEEEEEEEEEEEEEEEEEEEEEEEEEEEEEEEEEEEEEEEEEEEEEEEEEEEEEEEEEEEEEEEEEEEEEEEEEEEEEEEEB
BBBBBBBBBBBBBBBBBBBBBBBBBBBBBBBBBBBBBBBBBBBBBBBBBBBBBBBBBBBBBBBBBBBBBBBBBBBBBBBBBBBBBBBBBBBBBBBBBBBB
