12 10 100
5 5 1
1 1 4 1
10 8 4 3
BBBBBBBBBBBB
BEEEEEEEEEEB
BEEEEEEEEEEB
BEEEEEEEEEEB
BEEEEBBEEEEB
BEEEEBBEEEEB
BEEEEEEEEEEB
BEEEEEEEEEEB
BEEEEEEEEEEB
BBBBBBBBBBBB
